bg1
......@......
.............
^r^p^b^g^w^t^
.r.p.b.g.w.t.
.r.p.b.g.w.t.
.r.p.b.g.w.t.
.r.p.b.g.w.t.
.r.p.b.g.w.t.
.r.p.b.g.w.t.