bg3
......-......
M-.........-N
rrrrrrrrrrrrr
M-.........-N
bbbbbbbbbbbbb
M-.........-N
ppppppppppppp
N-.........-N
ggggggggggggg
M-.........-M
#############