bg1
......@......
.............
OOOOOO.OOOOOO
.............
rrrrrrrrrrrrr
.............
^OOOOO^OOOOO^
.............
.............
OOO^OO^OO^OOO
.............
ppppppppppppp
.............
^OO^OO^OO^OO^