bg3
....O.b.O....
..O.O.O.O.O..
..O.O.O.O.O..
..O.OtO.O.O..
..O.O.O.O.O..
..O.O.OwO.O..
..O.O.O.O.O..
..O.O.O.O.O..
..O.O.O.O.O..
..O.p.O.p.O..
..OOOOOOOOO..
.............