bg3
....b.t.rO...
.........Ob..
.*.......O...
b........O...
.........O..b
..t......O...
....*r...Ob..
.........O...
*........O..b
...*.....O...
.........O...
.........O.@.
........rO...
.b....t..O*OO
.............
bt...........
......r......
.............