bg3
.............
.............
....O...O....
.OtOtOtOtOtO.
..G...G...G..
.............
.............
..G...G...G..
.OrOrOrOrOrO.
....O...O....
.............
.............
....O...O....
.ObObObObObO.
..G...G...G..