bg2
4
......@......
.............
.###########.
.#.........#.
.#.#######.#.
.#.#.....#.#.
.#.#.%...#.#.
.#.#.....#.#.
.#.#.....#.#.
.#.#.....#.#.
.#.#.....#.#.
.#.#######.#.
.#.........#.
.###########.