bg3
.O....O......
.....OOO....O
...O..O..O...
O............
.....O.....O.
r.r..........
r..r..rr..rr.
r..r.r..r.r.r
r.r..r..r.r.r
r.....rr..r.r
r............
....O....O.O.
.O........OOO
OOO.O...O..O.
.O....O......