bg2
4
......@......
.............
.###########.
.#...p.....#.
y#.#######.#.
.#.#.....#.#w
.#.#.%...#.#.
.#.#.....#r#.
.#.#.....#.#.
t#.#.....#.#.
.#b#.....#.#.
.#.#######.#.
.#.....g...#.
.###########.