bg2
.............
.............
#############
#ggg#ppp#ttt#
#g###p#p##t##
#g###ppp##t##
#g###p#p##t##
#ggg#p#p##t##
#############
.............
..r.r........
.r.r.r.......
..rrr........
.............