bg2
.............
.............
...t...p.....
.-..._....O..
...b....y...-
.._..g....-..
.y.@...p.@.t.
...r.........
......-.._b..
.O..-...g....
......y....O.
..t..........