bg1
.............
.b..t...t..r.
.O..O.@.O..O.
.............
..b...t...r..
..O...O...O..
.............
.b.b.t.t.r.r.
.O.O.O.O.O.O.
.............
..b...t...r..
..O...O...O..
.............
.b..t...t..r.
.O..O...O..O.