bg4
4
.............
.@........@..
.............
.###########.
.#.........#.
.#.#######.#.
.#.#.....#.#.
.#.#.%...#.#.
.#.#.....#.#.
.#.#.....#.#.
.#.#.....#.#.
.#.#.....#.#.
.#.#######.#.
.#.........#.
.###########.
......@......