bg2
.............
..O--O.O__O..
..OrrO.ObbO..
..OppO.OwwO..
..ObbO.OyyO..
@.OwwO.OggO..
..OttO.OttO..
..OggO.OwwO..
..OyyO.ObbO..
..OwwO.OppO..
..ObbO.OrrO..
..O__O.O--O..