bg1
......r......
.....rgr.....
....rpppr....
...rbbbbbr...
..rgggggggr..
.rtttttttttr.
O...........O
.O....@....O.
..w.......w..
...O.....O...
....O...O....
.....O.O.....
......O......
.............
.............