bg1
.............
.rOr.rOr.rOr.
.###.###.###.
.pOp.pOp.pOp.
@###.###.###@
.bOb.bOb.bOb.
.###.###.###.
.gOg.gOg.gOg.
.###.###.###.
.wOw.wOw.wOw.
.###.###.###.
.tOt.tOt.tOt.
.###.###.###.
.yOy.yOy.yOy.