bg2
..@..........
.............
O.r.g.b.y.w.t
p.O.g.b.y.w.t
p.r.O.b.y.w.t
p.r.g.O.y.w.t
p.r.g.b.O.w.t
p.r.g.b.y.O.t
p.r.g.b.y.w.O