bg1
.............
.............
.............
.............
.............
.............
.............
.............
.............
ggggggggggggg
ppppppppppppp
bbbbbbbbbbbbb
wwwwwwwwwwwww
rrrrrrrrrrrrr
GGGGGGGGGGGGG
......@......