bg2
t.b.r.p.r.b.t
#.#.#.#.#.#.#
.g.w.t.t.w.g.
.#.#.#.#.#.#.
b.p.y.g.y.p.b
#.#.#.#.#.#.#
.r.t.w.w.t.r.
.#.#.#.#.#.#.
t.b.r.p.r.b.t
#.#.#.#.#.#.#
.g.w.t.t.w.g.
.#.#.#.#.#.#.
b.p.y.g.y.p.b
#.#.#.#.#.#.#