bg1
......@......
.............
.GGGGGGGGGGG.
.G.........G.
.G.rrrrrrr.G.
.G.r.....r.G.
.G.r.ppp.r.G.
.G.r.p.p.r.G.
.G.r.ppp.r.G.
.G.r.....r.G.
.G.rrrrrrr.G.
.G.........G.
.GGGGGGGGGGG.