bg3
.r.p.b.g.r.p.
r.p.b.g.r.p.b
.p.b.g.r.p.b.
p.b.g.r.p.b.g
.b.g.r.p.b.g.
b.g.r.p.b.g.r
.g.r.p.b.g.r.
g.r.p.b.g.r.p
.r.p.b.g.r.p.
r.p.b.g.r.p.b
.p.b.g.r.p.b.
p.b.g.r.p.b.g
.b.g.r.p.b.g.
b.g.r.p.b.g.r
......@......