bg3
4
.............
.............
...GGG.GGG...
...GbG.GbG...
...G-G.G-G...
...GGG.GGG...
.GG_....._GG.
.GbG..@..GbG.
.GbG.....GbG.
.GGG.....GGG.
.....GGG.....
...GGbbbGG...
..GGbb_bbGG..
..GbbbbbbbG..
..GGGGGGGGG..