bg2
.............
.OtO.OrO.OtO.
.OOO.OOO.OOO.
.............
...ObO.ObO...
...OOO.OOO...
.............
.OgO.OpO.OgO.
.OGO.OGO.OGO.
.OOO.OOO.OOO.