bg3
r.r.r.r.r.r.r
.............
r.OOOOOOOOO.r
.tOprb*brpOt.
r.Orbp.rpbO.r
.tObpr.pbrOt.
r.Oprb.brpO.r
.tOrbp.rpbOt.
r.Obpr.pbrO.r
.tOprb@brpOt.
r.Orbp.rpbO.r
.tObpr.pbrOt.
r.O.......O.r
..O.......O*O
OOO.......OOO