bg1
.............
G...........G
r...........r
GG.........GG
b...........b
GGG.......GGG
p...........p
GGGG.....GGGG
y.....M.....y
GGGG.....GGGG
p.....@.....p
GGG.......GGG
b...........b
GG.........GG
r...........r
G...........G