bg3
.............
...OrrrrrO...
...O.....O...
...ON....O...
...O.....O...
rrrObbbbbOrrr
...O..@..O...
...O....MO...
...O.....O...
pppOtttttOppp
...O.....O...
...ON....O...
...O.....O...
...ObbbbbO...