bg1
......@......
.O....O....O.
...O.....O...
O.....r.....O
...O.....O...
O..O..O..O..O
O...........O
.............
.O..O..O..O..
....O..O.....
.............
..O.O.O.O.O..
O.....O.....O
...O.....O...
.O.O.O.O.O.O.