bg3
.OrOgObOtOwO.
.O.w.w.w.w.O.
.OrOgObOtOwO.
.O.O.O.O.O.O.
.OrOgObOtOwO.
.O.O.O.O.O.O.
.OrOgObOtOwO.
.O.O.O.O.O.O.
.OrOgObOtOwO.
.O.O.O.O.O.O.
.OrOgObOtOwO.