bg1
......y......
.....ggg.....
....ppppp....
...bbbbbbb...
..ggggggggg..
.ttttttttttt.
O...........O
.O....@....O.
..w.......w..
...O.....O...
....O...O....
.....O.O.....
......O......
.............
.............