bg1
...G...r.....
.b...O..#...p
...#..p..y...
w...t.....b..
..G..b.#...G.
...y.@..g....
#.g....O...w.
....#.....#..
.O....G.....y
...y.....t.#.
r...p..O..g..
.b.O....t...w
....g....y...
.#....r....b.