bg1
......@......
.............
.OOOOO.OOOOO.
.O...O.O...O.
.OrrrO.OrrrO.
.OtttO.OtttO.
.OpppO.OpppO.
.OwwwO.OwwwO.
.ObbbO.ObbbO.
.OpppO.OpppO.
.OwwwO.OwwwO.
.ObbbO.ObbbO.
.O...O.O...O.
.OO-OO.OO_OO.