bg2
......@......
.............
.OtO.OrO.OtO.
.OOO.OOO.OOO.
.............
...ObO.ObO...
...OOO.OOO...
.............
.OGO.OGO.OGO.
.OpO.OrO.OpO.
.OOO.OOO.OOO.