bg2
......@......
.............
OOOOOrrrOOOOO
.............
OOOO-----OOOO
.............
OOOpppppppOOO
.............
OO___GGG___OO
.............
OtttttttttttO
.............
-------------