bg1
..r....b..w..
...O..p....t.
...y..t...g..
..G....y...O.
.r..@.O...#..
..p....t..p..
...O....O.G..
..y....g...b.
...r..p...r..
....t.w...#..
...p...O..t..
...g...y...p.
..r.......w..