bg3
rO...........
OO...........
.............
.............
#############
.............
.....########