bg2
.............
.............
..O.O.O.O.O..
..O.O.O.O.r..
..y.O.O.O.O..
..O.O.O.Obb..
..wwO.O.O.O..
..O.O.O.ppp..
..rrr.O.O.O..
..O.O.Otttt..
..bbbbO.O.O..
..O.O.ggggg..
..ppppp.O.O..
..OOOOOOOOO..