bg3
.............
.w.r.b.p.y.g.
.w.r.b.p.y.g.
.w.r.b.p.y.g.
.w.r.b.p.y.g.
.w.r.b.p.y.g.
.w.r.b.p.y.g.
.w.r.b.p.y.g.
.G.G.G.G.G.G.
